Entity,Capital,Latitude,Longitude,Code,60Rural_Pop,60Urban_Pop,60Tot_pop,1960Perc_Urban,70Rural_Pop,70Urban_Pop,70Tot_pop,1970Perc_Urban,80Rural_Pop,80Urban_Pop,80Tot_pop,1980Perc_Urban,90Rural_Pop,90Urban_Pop,90Tot_pop,1990Perc_Urban,00Rural_Pop,00Urban_Pop,00Tot_pop,2000Perc_Urban,10Rural_Pop,10Urban_Pop,10Tot_pop,2010Perc_Urban,17Rural_Pop,17Urban_Pop, 17Tot_pop ,2017Perc_Urban,popClass
Afghanistan,Kabul,34.575503,69.240073,AFG,8240568,755783,8996351,8.4,9830708,1295415,11126123,11.64,11129293,2119077,13248370,16,9655119,2593995,12249114,21.18,15657457,4436299,20093756,22.08,21966159,6837008,28803167,23.74,26558736,8971345,"35,530,081",25.25,10-50  million
Albania,Tirana,41.327546,19.818698,ALB,1114818,493982,1608800,30.7,1457678,677801,2135479,31.74,1769877,902120,2671997,33.76,2089320,1197222,3286542,36.43,1799636,1289391,3089027,41.74,1393502,1519519,2913021,52.16,1167112,1706345,"2,873,457",59.38,1-5 million
Algeria,Algiers,36.752887,3.042048,DZA,7730685,3394203,11124888,30.51,8802771,5747263,14550034,39.5,10917687,8420028,19337715,43.54,12415911,13496456,25912367,52.08,12498723,18684937,31183660,59.92,11723785,24393852,36117637,67.54,11547594,29770548,"41,318,142",72.05,10-50  million
American Samoa,Pago Pago,-14.275632,-170.702036,ASM,6762,13251,20013,66.21,8083,19209,27292,70.38,8332,24125,32457,74.33,8962,38076,47038,80.95,6565,50956,57521,88.59,6902,48735,55637,87.59,7139,48502,"55,641",87.17,"Less than 100,000"
Andorra,Andorra la Vella,42.506317,1.521835,AND,5572,7839,13411,58.45,4818,19458,24276,80.15,2862,33205,36067,92.06,2882,51627,54509,94.71,4973,60417,65390,92.39,9442,75007,84449,88.82,9120,67845,"76,965",88.15,"Less than 100,000"
Angola,Luanda,-8.839988,13.289437,AGO,5054316,588866,5643182,10.43,5762838,1013543,6776381,14.96,6760113,2169787,8929900,24.3,7650481,4520960,12171441,37.14,8206158,8234766,16440924,50.09,9398363,13970768,23369131,59.78,10472420,19311773,"29,784,193",64.84,10-50  million
Antigua and Barbuda,St. John's,17.12741,-61.846772,ATG,33394,21945,55339,39.66,44406,22692,67098,33.82,48018,25424,73442,34.62,43068,23628,66696,35.43,56731,26853,83584,32.13,69824,24837,94661,26.24,76802,25210,"102,012",24.71,"100,000 to 1 million"
Argentina,Buenos Aires,-34.603684,-58.381559,ARG,5441168,15177907,20619075,73.61,5063110,18909948,23973058,78.88,4809761,23296127,28105888,82.89,4260103,28469636,32729739,86.98,4023698,33033754,37057452,89.14,3772398,37451491,41223889,90.85,3652804,40618237,"44,271,041",91.75,10-50  million
Armenia,Yerevan,40.179186,44.499103,ARM,913165,960955,1874120,51.27,1013460,1511605,2525065,59.86,1052365,2047386,3099751,66.05,1152699,2385466,3538165,67.42,1084608,1984980,3069588,64.67,1051945,1825366,2877311,63.44,1081248,1849202,"2,930,450",63.1,1-5 million
Aruba,Oranjestad,12.509204,-70.008631,ABW,26685,27526,54211,50.78,29163,29900,59063,50.62,29764,30332,60096,50.47,30876,31273,62149,50.32,48409,42444,90853,46.72,57891,43778,101669,43.06,59692,45572,"105,264",43.29,"100,000 to 1 million"
Australia,Canberra,-35.282,149.128684,AUS,1898168,8378309,10276477,81.53,2001245,10505755,12507000,84,2122700,12569300,14692000,85.55,2485873,14579227,17065100,85.43,3019470,16133530,19153000,84.24,3264665,18767085,22031750,85.18,3467466,21131467,"24,598,933",85.9,10-50  million
Austria,Vienna,48.208174,16.373819,AUT,2486372,4561167,7047539,64.72,2594215,4872871,7467086,65.26,2612783,4936650,7549433,65.39,2843876,4833974,7677850,62.96,3187562,4824004,8011566,60.21,3562894,4800510,8363404,57.4,3691588,5117624,"8,809,212",58.09,5-10 million
Azerbaijan,Baku,40.409262,49.867092,AZE,1843964,2051432,3895396,52.66,2589598,2590427,5180025,50.01,2904563,3246175,6150738,52.78,3311109,3847891,7159000,53.75,3912746,4135854,8048600,51.39,4218775,4835557,9054332,53.41,4404265,5458164,"9,862,429",55.34,5-10 million
Bahamas,Nassau,25.047984,-77.355413,BHS,44127,65401,109528,59.71,56286,113068,169354,66.76,56664,153997,210661,73.1,51682,204654,256336,79.84,53599,244291,297890,82.01,63409,297423,360832,82.43,67508,327853,"395,361",82.92,"100,000 to 1 million"
Bahrain,Manama,26.228516,50.58605,BHR,28717,133710,162427,82.32,34495,178110,212605,83.78,50021,309867,359888,86.1,58817,437114,495931,88.14,77281,587333,664614,88.37,141036,1099826,1240862,88.63,161408,1331176,"1,492,584",89.19,1-5 million
Bangladesh,Dhaka,23.810332,90.412518,BGD,45724690,2475057,48199747,5.13,60108693,4939077,65047770,7.59,69371623,12099237,81470860,14.85,85151610,21037032,106188642,19.81,100541228,31040015,131581243,23.59,105801443,46347659,152149102,30.46,105622472,59047279,"164,669,751",35.86,Over 50 million
Barbados,Bridgetown,13.113222,-59.598809,BRB,146007,84932,230939,36.78,149161,89687,238848,37.55,151059,101135,252194,40.1,163072,97302,260374,37.37,178566,91281,269847,33.83,190470,89099,279569,31.87,196692,89027,"285,719",31.16,"100,000 to 1 million"
Belarus,Minsk,53.90454,27.561524,BLR,5541766,2656234,8198000,32.4,5061496,3978504,9040000,44.01,4194898,5448102,9643000,56.5,3466196,6722804,10189000,65.98,2996577,6983033,9979610,69.97,2403775,7086808,9490583,74.67,2078992,7428883,"9,507,875",78.13,5-10 million
Belgium,Brussels,50.85034,4.35171,BEL,690173,8463316,9153489,92.46,594492,9061057,9655549,93.84,455398,9403844,9859242,95.38,361118,9606261,9967379,96.38,294313,9956937,10251250,97.13,255937,10639649,10895586,97.65,231876,11140192,"11,372,068",97.96,10-50  million
Belize,Belmopan,17.251011,-88.75902,BLZ,42324,49740,92064,54.03,59914,62268,122182,50.96,72980,71175,144155,49.37,98530,89022,187552,47.47,135039,112276,247315,45.4,176151,145457,321608,45.23,203823,170858,"374,681",45.6,"100,000 to 1 million"
Benin,Porto-Novo,6.496857,2.628852,BEN,2206089,225533,2431622,9.28,2426241,486099,2912340,16.69,2700929,1016236,3717165,27.34,3261662,1716834,4978496,34.48,4234026,2631925,6865951,38.33,5235022,3964237,9199259,43.09,5949044,5226648,"11,175,692",46.77,10-50  million
Bermuda,Hamilton,32.294816,-64.781375,BMU,0,44400,44400,100,0,55000,55000,100,0,54670,54670,100,0,59326,59326,100,0,61833,61833,100,0,65124,65124,100,0,65441,"65,441",100,"Less than 100,000"
Bhutan,Thimphu,27.472792,89.639286,BTN,215259,8029,223288,3.6,280137,18164,298301,6.09,367715,41457,409172,10.13,449231,88049,537280,16.39,427665,145751,573416,25.42,474473,253168,727641,34.79,483217,324393,"807,610",40.17,"100,000 to 1 million"
Bolivia,La Paz,-16.489689,-68.119294,BOL,2335663,1357786,3693449,36.76,2713560,1792218,4505778,39.78,3049057,2540518,5589575,45.45,3045749,3810495,6856244,55.58,3186778,5152734,8339512,61.79,3329554,6588688,9918242,66.43,3417155,7634445,"11,051,600",69.08,10-50  million
Bosnia and Herzegovina,Sarajevo,43.856259,18.413076,BIH,2611501,614167,3225668,19.04,2737626,1022901,3760527,27.2,2694209,1485646,4179855,35.54,2711573,1751849,4463422,39.25,2170225,1596481,3766706,42.38,2026377,1695707,3722084,45.56,1827998,1679019,"3,507,017",47.88,1-5 million
Botswana,Gaborone,-24.628208,25.923147,BWA,508501,16051,524552,3.06,641104,54493,695597,7.83,836177,164981,1001158,16.48,800112,577800,1377912,41.93,808535,919805,1728340,53.22,757348,1257518,2014866,62.41,717290,1574371,"2,291,661",68.7,1-5 million
Brazil,BrasÃ­lia,-15.794229,-47.882166,BRA,38891711,33315843,72207554,46.14,42030536,53296257,95326793,55.91,41838889,79320872,121159761,65.47,38948052,110404093,149352145,73.92,32968089,142319498,175287587,81.19,30828136,165968133,196796269,84.33,28653658,180634620,"209,288,278",86.31,Over 50 million
British Virgin Islands,Road Town,18.428612,-64.618466,VGB,7051,982,8033,12.22,8172,1631,9803,16.64,8500,2502,11002,22.74,10236,6225,16461,37.82,12021,8624,20645,41.77,15024,12200,27224,44.81,16429,14767,"31,196",47.34,"Less than 100,000"
Brunei,Bandar Seri Begawan,4.903052,114.939821,BRN,46267,35478,81745,43.4,49663,79920,129583,61.67,67981,125968,193949,64.95,86853,171932,258785,66.44,96093,237148,333241,71.16,97317,291345,388662,74.96,97263,331434,"428,697",77.31,"100,000 to 1 million"
Bulgaria,Sofia,42.697708,23.321868,BGR,4948578,2918796,7867374,37.1,4049527,4440047,8489574,52.3,3358522,5503013,8861535,62.1,2931350,5786939,8718289,66.38,2541005,5629167,8170172,68.9,2048433,5347166,7395599,72.3,1792419,5283572,"7,075,991",74.67,5-10 million
Burkina Faso,Ouagadougou,12.371428,-1.51966,BFA,4602311,226977,4829288,4.7,5301410,323190,5624600,5.75,6222092,600751,6822843,8.8,7593790,1217244,8811034,13.81,9536621,2071321,11607942,17.84,11761184,3844033,15605217,24.63,13676628,5516754,"19,193,382",28.74,10-50  million
Burundi,Bujumbura,-3.361378,29.359878,BDI,2728239,57867,2786106,2.08,3357294,98312,3455606,2.85,3938188,178629,4116817,4.34,5075814,339601,5415415,6.27,5872904,527802,6400706,8.25,7833953,932977,8766930,10.64,9483834,1380411,"10,864,245",12.71,10-50  million
Cambodia,Phnom Penh,11.544873,104.892167,KHM,5133824,588546,5722370,10.29,5877771,1117077,6994848,15.97,6029722,662385,6692107,9.9,7578346,1394996,8973342,15.55,9893717,2258637,12152354,18.59,11404924,2903816,14308740,20.29,12327338,3678035,"16,005,373",22.98,10-50  million
Cameroon,YaoundÃ©,3.848033,11.502075,CMR,4454852,721416,5176268,13.94,5202525,1325110,6527635,20.3,5867289,2751065,8618354,31.92,7069314,4645904,11715218,39.66,8318042,6956192,15274234,45.54,9673907,10296588,19970495,51.56,10637280,13416447,"24,053,727",55.78,10-50  million
Canada,Ottawa,45.42153,-75.697193,CAN,5540868,12368141,17909009,69.06,5191541,16132459,21324000,75.65,5985198,18607802,24593000,75.66,6508096,21282904,27791000,76.58,6314558,24455142,30769700,79.48,6482425,27522849,34005274,80.94,6846057,29862026,"36,708,083",81.35,10-50  million
Cape Verde,Praia,14.93305,-23.513327,CPV,168567,33743,202310,16.68,217350,52848,270198,19.56,219241,67416,286657,23.52,191044,150839,341883,44.12,202595,232484,435079,53.43,191805,310579,502384,61.82,189810,356578,"546,388",65.26,"100,000 to 1 million"
Cayman Islands,George Town,19.286932,-81.367439,CYM,0,7865,7865,100,0,9144,9144,100,0,16162,16162,100,0,25010,25010,100,0,41687,41687,100,0,55507,55507,100,0,61559,"61,559",100,"Less than 100,000"
Central African Republic,Bangui,4.394674,18.55819,CAF,1201303,302205,1503508,20.1,1325960,502749,1828709,27.49,1507554,772267,2279821,33.87,1857206,1082574,2939780,36.83,2341647,1413339,3754986,37.64,2717871,1730654,4448525,38.9,2749789,1909291,"4,659,080",40.98,1-5 million
Chad,N'Djamena,12.134846,15.055742,TCD,2800636,200957,3001593,6.7,3222063,421486,3643549,11.57,3664365,847677,4512042,18.79,4717177,1239682,5956859,20.81,6537480,1805079,8342559,21.64,9273801,2613401,11887202,21.98,11494153,3405841,"14,899,994",22.86,10-50  million
Chile,Santiago,-33.44889,-70.669265,CHL,2481975,5234650,7716625,67.84,2369256,7194609,9563865,75.23,2113206,9153020,11266226,81.24,2215276,11026856,13242132,83.27,2125644,13137110,15262754,86.07,2196561,14796793,16993354,87.07,2258646,15796080,"18,054,726",87.49,10-50  million
China,Beijing,39.904211,116.407395,CHN,558984648,108085352,667070000,16.2,675928190,142386810,818315000,17.4,791287529,189947471,981235000,19.36,835019382,300165618,1135185000,26.44,809645853,452999147,1262645000,35.88,679206337,658498663,1337705000,49.23,582840458,803554542,"1,386,395,000",57.96,Over 50 million
Colombia,BogotÃ¡,4.710989,-74.072092,COL,8855239,7625144,16480383,46.27,9566846,12494369,22061215,56.63,10058317,17679583,27737900,63.74,10459339,23812226,34271565,69.48,10522403,29881555,40403958,73.96,10118512,35799585,45918097,77.96,9594290,39471325,"49,065,615",80.45,10-50  million
Comoros,Moroni,-11.717216,43.247315,COM,167133,23988,191121,12.55,185447,44607,230054,19.39,236366,71463,307829,23.22,296887,114707,411594,27.87,390063,152294,542357,28.08,496764,192928,689692,27.97,579636,234276,"813,912",28.78,"100,000 to 1 million"
Congo,Brazzaville,-4.26336,15.242885,COG,709448,327772,1037220,31.6,830775,534037,1364812,39.13,959397,880538,1839935,47.86,1114703,1325754,2440457,54.32,1332387,1893340,3225727,58.69,1611846,2774847,4386693,63.26,1764508,3496242,"5,260,750",66.46,5-10 million
Costa Rica,San JosÃ©,9.928069,-84.090725,CRI,876420,456620,1333040,34.25,1131007,717859,1848866,38.83,1359541,1029769,2389310,43.1,1547905,1548090,3095995,50,1607390,2318053,3925443,59.05,1284678,3260602,4545280,71.74,1051797,3853972,"4,905,769",78.56,1-5 million
Cote d'Ivoire,Yamoussoukro,6.827623,-5.289343,CIV,2929795,629193,3558988,17.68,3765979,1476416,5242395,28.16,5239197,3054478,8293675,36.83,7441006,4826748,12267754,39.35,9485476,7201085,16686561,43.15,10745381,9655950,20401331,47.33,12068174,12226576,"24,294,750",50.33,10-50  million
Croatia,Zagreb ,45.815011,15.981919,HRV,2891624,1248376,4140000,30.15,2637954,1773046,4411000,40.2,2418564,2169436,4588000,47.29,2340431,2439569,4780000,51.04,2061277,2364723,4426000,53.43,1981154,2436627,4417781,55.15,1787790,2337910,"4,125,700",56.67,1-5 million
Cuba,Havana,23.05407,-82.345189,CUB,2970641,4170494,7141135,58.4,3462867,5252256,8715123,60.27,3136831,6698346,9835177,68.11,2818643,7763438,10582081,73.36,2751667,8399069,11150736,75.32,2652274,8680777,11333051,76.6,2644108,8840528,"11,484,636",76.98,10-50  million
Curacao,Willemstad,12.122422,-68.882423,CUW,31568,93258,124826,74.71,31194,113545,144739,78.45,26989,121052,148041,81.77,22278,123122,145400,84.68,12379,121481,133860,90.75,15012,133691,148703,89.9,17385,143629,"161,014",89.2,"100,000 to 1 million"
Cyprus,Nicosia,35.185566,33.382276,CYP,368806,204124,572930,35.63,363503,250118,613621,40.76,283662,401744,685406,58.61,254700,511914,766614,66.78,295739,647547,943286,68.65,361030,751577,1112607,67.55,391186,788365,"1,179,551",66.84,1-5 million
Czechia,Prague,50.075538,14.4378,CZE,3884203,5717803,9602006,59.55,3509276,6348795,9858071,64.4,2558840,7745353,10304193,75.17,2560605,7772750,10333355,75.22,2667547,7587516,10255063,73.99,2801381,7673029,10474410,73.25,2788166,7803157,"10,591,323",73.67,10-50  million
Democratic Republic of Congo,Kinshasa,-4.441931,15.266293,COD,11847891,3400360,15248251,22.3,15085890,4924045,20009935,24.61,19221970,7135492,26357462,27.07,24011096,10603485,34614581,30.63,30542218,16534169,47076387,35.12,38705570,25817693,64523263,40.01,45648001,35691987,"81,339,988",43.88,Over 50 million
Denmark,Copenhagen,55.676097,12.568337,DNK,1205031,3374572,4579603,73.69,998714,3930043,4928757,79.74,833875,4289152,5123027,83.72,779212,4361727,5140939,84.84,795603,4544013,5339616,85.1,732572,4815111,5547683,86.79,706372,5063231,"5,769,603",87.76,5-10 million
Djibouti,Djibouti,11.572077,43.145647,DJI,41546,42090,83636,50.33,61026,98633,159659,61.78,100164,258796,358960,72.1,141949,448449,590398,75.96,168403,549181,717584,76.53,195772,655374,851146,77,213905,743080,"956,985",77.65,"100,000 to 1 million"
Dominica,Roseau,15.309168,-61.379355,DMA,37299,22712,60011,37.85,43580,27493,71073,38.68,40098,35216,75314,46.76,26187,44739,70926,63.08,24202,45474,69676,65.26,22794,48646,71440,68.09,22044,51881,"73,925",70.18,"Less than 100,000"
Dominican Republic,Santo Domingo,18.486058,-69.931212,DOM,2299538,994504,3294042,30.19,2689530,1813584,4503114,40.27,2829695,2979574,5809269,51.29,3216406,3967241,7183647,55.23,3274946,5287676,8562622,61.75,2597924,7300061,9897985,73.75,2123575,8643423,"10,766,998",80.28,10-50  million
Ecuador,Quito,-0.180653,-78.467838,ECU,3005609,1539941,4545550,33.88,3687360,2385167,6072527,39.28,4230627,3745818,7976445,46.96,4588945,5629146,10218091,55.09,5013679,7614917,12628596,60.3,5572133,9362557,14934690,62.69,6039811,10585047,"16,624,858",63.67,10-50  million
Egypt,Cairo,30.04442,31.235712,EGY,16774566,10221967,26996533,37.86,20510130,14536143,35046273,41.48,24758140,19341002,44099142,43.86,32450532,24961683,57412215,43.48,39988322,29917666,69905988,42.8,47925355,36182251,84107606,43.02,55893078,41660073,"97,553,151",42.7,Over 50 million
El Salvador,San Salvador,13.69294,-89.218191,SLV,1703217,1059682,2762899,38.35,2221738,1446857,3668595,39.44,2560659,2020045,4580704,44.1,2665643,2589341,5254984,49.27,2410890,3456736,5867626,58.91,2129755,4034871,6164626,65.45,1832038,4545815,"6,377,853",71.28,5-10 million
Equatorial Guinea,Malabo,3.750412,8.737104,GNQ,190121,65202,255323,25.54,223897,82618,306515,26.95,184161,71164,255325,27.87,278538,148308,426846,34.75,312740,301583,614323,49.09,323946,627158,951104,65.94,359441,908248,"1,267,689",71.65,1-5 million
Eritrea,Asmara,15.322877,38.925052,ERI,1260551,136940,1397491,9.8,1582168,229710,1811878,12.68,2042261,343279,2385540,14.39,2524740,588571,3113311,18.9,2490757,902044,3392801,26.59,2846362,1544478,4390840,35.18,3109000,2079000,"5,188,000",40.1,5-10 million
Estonia,Tallinn,59.436961,24.753575,EST,514503,697034,1211537,57.53,476747,883329,1360076,64.95,447435,1029784,1477219,69.71,451436,1117738,1569174,71.23,427924,969061,1396985,69.37,424820,906655,1331475,68.09,411522,903958,"1,315,480",68.72,1-5 million
Ethiopia,Addis Ababa,8.980603,38.757761,ETH,20726286,1424992,22151278,6.43,25974790,2440287,28415077,8.59,31593822,3671076,35264898,10.41,42017517,6068999,48086516,12.62,56729728,9807603,66537331,14.74,72513445,15189225,87702670,17.32,83640582,21316856,"104,957,438",20.31,Over 50 million
Fiji,Suva,-18.124809,178.450079,FJI,276625,116761,393386,29.68,339604,180925,520529,34.76,395326,239929,635255,37.77,425439,303189,728628,41.61,422582,388641,811223,47.91,411305,448645,859950,52.17,400757,504745,"905,502",55.74,"100,000 to 1 million"
Finland,Helsinki,60.173324,24.941025,FIN,1980489,2449145,4429634,55.29,1671905,2934402,4606307,63.7,1351318,3428217,4779535,71.73,1028850,3957581,4986431,79.37,922245,4253964,5176209,82.18,870472,4492880,5363352,83.77,808784,4702519,"5,511,303",85.32,5-10 million
France,Paris,48.856614,2.352222,FRA,17845587,28968650,46814237,61.88,15061558,36973537,52035095,71.06,14785950,40554832,55340782,73.28,15180563,43332245,58512808,74.06,14697577,46214923,60912500,75.87,14066100,50961407,65027507,78.37,13302916,53815732,"67,118,648",80.18,Over 50 million
French Polynesia,Papeete,-17.551625,-149.558476,PYF,45065,33011,78076,42.28,49544,60951,110495,55.16,62196,89512,151708,59,83611,114764,198375,57.85,104282,132976,237258,56.05,106279,161541,267820,60.32,108154,174853,"283,007",61.78,"100,000 to 1 million"
Gabon,Libreville,0.416198,9.467268,GAB,412336,86848,499184,17.4,401280,188838,590118,32,330440,398719,729159,54.68,293824,658388,952212,69.14,260025,971097,1231122,78.88,237289,1402921,1640210,85.53,223251,1801886,"2,025,137",88.98,1-5 million
Gambia,Banjul,13.454876,-16.579032,GMB,323302,44626,367928,12.13,360082,87203,447285,19.5,432644,171725,604369,28.41,565561,351247,916808,38.31,642185,589659,1231844,47.87,750265,941884,1692149,55.66,827645,1272923,"2,100,568",60.6,1-5 million
Georgia,Tbilisi,41.715138,44.827096,GEO,2075477,1570123,3645600,43.07,2142101,1977799,4119900,48.01,2122292,2345408,4467700,52.5,2159075,2642925,4802000,55.04,2092595,2325705,4418300,52.64,1745696,2180304,3926000,55.53,1552595,2164505,"3,717,100",58.23,1-5 million
Germany,Berlin,52.520007,13.404954,DEU,20836712,51978188,72814900,71.38,21673217,56496072,78169289,72.27,21260046,57028530,78288576,72.84,21353187,58079842,79433029,73.12,20581651,61629857,82211508,74.97,18836498,62940432,81776930,76.97,18804016,63890984,"82,695,000",77.26,Over 50 million
Ghana,Accra,5.603717,-0.186964,GHA,5105497,1546790,6652287,23.25,6107469,2489514,8596983,28.96,7435792,3366236,10802028,31.16,9297576,5330684,14628260,36.44,10619153,8319609,18938762,43.93,12081281,12430823,24512104,50.71,12857780,15975849,"28,833,629",55.41,10-50  million
Gibraltar,Gibraltar,36.140773,-5.353599,GIB,0,23394,23394,100,0,28560,28560,100,0,30272,30272,100,0,29164,29164,100,0,31180,31180,100,0,33189,33189,100,0,34571,"34,571",100,"Less than 100,000"
Greece,Athens,37.983917,23.72936,GRC,3671291,4660434,8331725,55.94,3146066,5646740,8792806,64.22,2956103,6686402,9642505,69.34,2909451,7287341,10196792,71.47,2948257,7857551,10805808,72.72,2636648,8484693,11121341,76.29,2289387,8471034,"10,760,421",78.72,10-50  million
Greenland,Nuuk,64.18141,-51.694138,GRL,13476,19024,32500,58.54,12647,33753,46400,72.74,11987,38213,50200,76.12,11288,44312,55600,79.7,10341,45859,56200,81.6,8887,48018,56905,84.38,7542,48629,"56,171",86.57,"Less than 100,000"
Grenada,St. George's,12.056098,-61.7488,GRD,62610,27259,89869,30.33,64009,30417,94426,32.21,59712,29293,89005,32.91,64098,32185,96283,33.43,65343,36276,101619,35.7,67135,37542,104677,35.86,68831,38994,"107,825",36.16,"100,000 to 1 million"
Guam,HagÃ¥tÃ±a,13.470891,144.751278,GUM,33273,33469,66742,50.15,31940,51937,83877,61.92,6505,97628,104133,93.75,12010,118472,130482,90.8,10673,144656,155329,93.13,9409,150035,159444,94.1,8706,155523,"164,229",94.7,"100,000 to 1 million"
Guatemala,Guatemala City,14.634915,-90.506882,GTM,2900320,1310427,4210747,31.12,3623526,1998266,5621792,35.55,4463012,2820447,7283459,38.72,5373753,3890060,9263813,41.99,6369228,5281515,11650743,45.33,7548856,7081561,14630417,48.4,8341740,8571763,"16,913,503",50.68,10-50  million
Guinea,Conakry,9.641185,-13.578401,GIN,3202783,374626,3577409,10.47,3545577,674193,4219770,15.98,3446326,1065576,4511902,23.62,4348017,1693077,6041094,28.03,6089436,2719110,8808546,30.87,7158909,3635261,10794170,33.68,8165317,4551859,"12,717,176",35.79,10-50  million
Guinea-Bissau,Bissau,11.881655,-15.617794,GNB,532577,83832,616409,13.6,604113,107714,711827,15.13,658270,142584,800854,17.8,700194,312086,1012280,30.83,792646,450583,1243229,36.24,931801,624079,1555880,40.11,1061955,799328,"1,861,283",42.95,1-5 million
Guyana,Georgetown,6.801279,-58.155125,GUY,405940,165879,571819,29.01,497507,207427,704934,29.43,542300,237853,780153,30.49,523416,219893,743309,29.58,537149,216152,753301,28.69,547718,198838,746556,26.63,571431,206428,"777,859",26.54,"100,000 to 1 million"
Haiti,Port-au-Prince,18.594395,-72.307433,HTI,3263309,602850,3866159,15.59,3778120,930522,4708642,19.76,4520292,1168544,5688836,20.54,5075598,2024134,7099732,28.51,5505685,3043515,8549200,35.6,5248899,4750718,9999617,47.51,5013370,5967859,"10,981,229",54.35,10-50  million
Honduras,Tegucigalpa,14.072275,-87.192136,HND,1574908,463729,2038637,22.75,1931490,785169,2716659,28.9,2395668,1282618,3678286,34.87,2950402,2004926,4955328,40.46,3558474,2965809,6524283,45.46,3942917,4251861,8194778,51.89,4034288,5230779,"9,265,067",56.46,5-10 million
Hong Kong,Hong Kong,22.396428,114.109497,HKG,455190,2620415,3075605,85.2,485809,3473191,3959000,87.73,431477,4631623,5063100,91.48,27553,5676947,5704500,99.52,0,6665000,6665000,100,0,7024200,7024200,100,0,7391700,"7,391,700",100,5-10 million
Hungary,Budapest,47.497912,19.040235,HUN,4401831,5582136,9983967,55.91,4123586,6214324,10337910,60.11,3835546,6875576,10711122,64.19,3543962,6830026,10373988,65.84,3617236,6593735,10210971,64.58,3108907,6891116,10000023,68.91,2830463,6950664,"9,781,127",71.06,5-10 million
Iceland,ReykjavÃ­k,64.126521,-21.817439,ISL,34588,140986,175574,80.3,30870,173568,204438,84.9,26783,201355,228138,88.26,23571,231255,254826,90.75,21369,259836,281205,92.4,20437,297604,318041,93.57,21252,320032,"341,284",93.77,"100,000 to 1 million"
India,New Delhi,28.613939,77.209021,IND,368915704,80564904,449480608,17.92,444191399,109387114,553578513,19.76,535840460,160943057,696783517,23.1,647840480,222293000,870133480,25.55,761703316,291347596,1053050912,27.67,850238363,380742328,1230980691,30.93,889215604,449964523,"1,339,180,127",33.6,Over 50 million
Indonesia,Jakarta,-6.208763,106.845599,IDN,74987099,12805416,87792515,14.59,95231335,19603445,114834780,17.07,114889095,32601270,147490365,22.1,125946184,55490637,181436821,30.58,122689218,88851211,211540429,42,121470632,121053491,242524123,49.91,119696331,144295048,"263,991,379",54.66,Over 50 million
Iran,Tehran,35.689198,51.388974,IRN,14516609,7390294,21906903,33.74,16762816,11751194,28514010,41.21,19452821,19215399,38668220,49.69,24553975,31672210,56226185,56.33,23779692,42352162,66131854,64.04,21903461,52664050,74567511,70.63,20782543,60380245,"81,162,788",74.39,Over 50 million
Iraq,Baghdad,33.312806,44.361488,IRQ,4162526,3127235,7289761,42.9,4348639,5569344,9917983,56.15,4707541,8945815,13653356,65.52,5292060,12176945,17469005,69.71,7424048,16141365,23565413,68.5,9504752,21257949,30762701,69.1,11375982,26898636,"38,274,618",70.28,10-50  million
Ireland,Dublin,53.349805,-6.26031,IRL,1550525,1278075,2828600,45.18,1440890,1516360,2957250,51.28,1524395,1888405,3412800,55.33,1513504,2000470,3513974,56.93,1554223,2250951,3805174,59.16,1753744,2806411,4560155,61.54,1783586,3030022,"4,813,608",62.95,1-5 million
Isle of Man,Douglas,54.152337,-4.486123,IMN,21739,26703,48442,55.12,24481,30944,55425,55.83,30642,32909,63551,51.78,33020,35409,68429,51.75,34954,37600,72554,51.82,38439,41633,80072,51.99,40072,44215,"84,287",52.46,"Less than 100,000"
Israel,Tel Aviv,32.0853,34.781768,ISR,489438,1624582,2114020,76.85,470041,2503959,2974000,84.19,442751,3435249,3878000,88.58,449271,4210729,4660000,90.36,553243,5735757,6289000,91.2,623153,7000447,7623600,91.83,667718,8044682,"8,712,400",92.34,5-10 million
Italy,Rome,41.902784,12.496366,ITA,20400656,29799044,50199700,59.36,19229471,34592379,53821850,64.27,18826343,37607540,56433883,66.64,18872760,37846480,56719240,66.73,18664484,38277624,56942108,67.22,18774936,40502481,59277417,68.33,18078231,42473185,"60,551,416",70.14,Over 50 million
Jamaica,Kingston,18.042327,-76.802893,JAM,1078408,549844,1628252,33.77,1100399,774982,1875381,41.32,1152059,1010986,2163045,46.74,1225600,1198642,2424242,49.44,1280236,1376628,2656864,51.81,1303157,1514053,2817210,53.74,1289709,1600590,"2,890,299",55.38,1-5 million
Japan,Tokyo,35.709026,139.731992,JPN,33973610,58526962,92500572,63.27,29344944,75000056,104345000,71.88,27823311,88958689,116782000,76.18,27994720,95542280,123537000,77.34,27082249,99760751,126843000,78.65,11767072,116302928,128070000,90.81,10732418,116053379,"126,785,797",91.53,Over 50 million
Jordan,Amman,31.956578,35.945695,JOR,457934,474323,932257,50.88,756820,962093,1718913,55.97,949080,1425342,2374422,60.03,950996,2609586,3560582,73.29,1108910,3994220,5103130,78.27,999214,6183176,7182390,86.09,897759,8804594,"9,702,353",90.75,5-10 million
Kazakhstan,Astana,51.160523,71.470356,KAZ,5420751,4293509,9714260,44.2,6348515,6408730,12757245,50.24,6658088,7860836,14518924,54.14,7149634,9198366,16348000,56.27,6534209,8349417,14883626,56.1,7046642,9275230,16321872,56.83,7695581,10342065,"18,037,646",57.34,10-50  million
Kenya,Nairobi,-1.292066,36.821946,KEN,7508718,596722,8105440,7.36,10094048,1158444,11252492,10.29,13733793,2535197,16268990,15.58,19483055,3919452,23402507,16.75,25194353,6256130,31450483,19.89,31603508,9746644,41350152,23.57,36498585,13201277,"49,699,862",26.56,10-50  million
Kiribati,Tarawa Atoll,1.451817,172.971662,KIR,34516,6717,41233,16.29,38850,12328,51178,24.09,40182,19157,59339,32.28,47077,25335,72412,34.99,48147,36259,84406,42.96,54005,48647,102652,47.39,54402,61996,"116,398",53.26,"100,000 to 1 million"
Kuwait,Kuwait City,29.375859,47.977405,KWT,67693,201925,269618,74.89,107079,639688,746767,85.66,71621,1300697,1372318,94.78,42538,2057077,2099615,97.97,20507,2030234,2050741,99,0,2998083,2998083,100,0,4136528,"4,136,528",100,1-5 million
Kyrgyzstan,Bishkek,42.874621,74.569762,KGZ,1429786,742514,2172300,34.18,1850944,1108956,2959900,37.47,2220107,1397293,3617400,38.63,2732336,1658864,4391200,37.78,3169363,1729037,4898400,35.3,3524464,1923436,5447900,35.31,3960588,2240912,"6,201,500",36.13,5-10 million
Laos,Vientiane,17.975706,102.633104,LAO,1952370,168526,2120896,7.95,2429667,258761,2688428,9.62,2854884,403260,3258144,12.38,3601092,657380,4258472,15.44,4158083,1171221,5329304,21.98,4368394,1877880,6246274,30.06,4501148,2357012,"6,858,160",34.37,5-10 million
Latvia,Riga,56.949649,24.105186,LVA,999681,1121298,2120979,52.87,926845,1432319,2359164,60.71,826475,1685226,2511701,67.1,818919,1844232,2663151,69.25,756030,1611520,2367550,68.07,674553,1423002,2097555,67.84,619581,1321159,"1,940,740",68.08,1-5 million
Lebanon,Beirut,33.888629,35.495479,LBN,1040666,764260,1804926,42.34,931017,1366372,2297389,59.47,685922,1919371,2605293,73.67,456269,2246747,2703016,83.12,452951,2782415,3235366,86,549342,3787799,4337141,87.33,703790,5378567,"6,082,357",88.43,5-10 million
Lesotho,Maseru,-29.363219,27.51436,LSO,821683,29908,851591,3.51,944125,88925,1033050,8.61,1160109,150009,1310118,11.45,1379916,224022,1603938,13.97,1503406,365293,1868699,19.55,1534535,506016,2040551,24.8,1614034,619305,"2,233,339",27.73,1-5 million
Liberia,Monrovia,6.290743,-10.760524,LBR,911576,208737,1120313,18.63,1047877,368652,1416529,26.03,1224251,664063,1888314,35.17,934904,1162328,2097232,55.42,1605785,1278737,2884522,44.33,2060408,1887717,3948125,47.81,2332972,2398934,"4,731,906",50.7,1-5 million
Libya,Tripoli,32.887209,13.191338,LBY,1052666,395751,1448417,27.32,1073782,1059744,2133526,49.67,962814,2256652,3219466,70.09,1077088,3359573,4436661,75.72,1264653,4091098,5355751,76.39,1354003,4815137,6169140,78.05,1286589,5088027,"6,374,616",79.82,5-10 million
Liechtenstein,Vaduz,47.14103,9.520928,LIE,13124,3371,16495,20.44,17341,3924,21265,18.45,21139,4727,25866,18.27,23881,4866,28747,16.93,28250,5036,33286,15.13,30796,5207,36003,14.46,32493,5429,"37,922",14.32,"Less than 100,000"
Lithuania,Vilnius,54.687156,25.279651,LTU,1682134,1096416,2778550,39.46,1583816,1555873,3139689,49.56,1325756,2087446,3413202,61.16,1198728,2499110,3697838,67.58,1155337,2344199,3499536,66.99,1029629,2067653,3097282,66.76,918557,1909164,"2,827,721",67.52,1-5 million
Luxembourg,Luxembourg,49.611621,6.131935,LUX,95585,218385,313970,69.56,86916,252255,339171,74.37,72677,291473,364150,80.04,72754,309096,381850,80.95,68866,367434,436300,84.22,58061,448892,506953,88.55,55587,543862,"599,449",90.73,"100,000 to 1 million"
Macao,Macau,22.166667,113.55,MAC,7905,159891,167796,95.29,7307,238888,246195,97.03,3527,234591,238118,98.52,815,343120,343935,99.76,0,427979,427979,100,0,536969,536969,100,0,622567,"622,567",100,"100,000 to 1 million"
Madagascar,Antananarivo,-18.87919,47.507905,MDG,4556698,542675,5099373,10.64,5649046,927259,6576305,14.1,7101899,1614654,8716553,18.52,8865299,2733334,11598633,23.57,11490691,4276115,15766806,27.12,14396229,6755411,21151640,31.94,16231893,9339002,"25,570,895",36.52,10-50  million
Malawi,Lilongwe,-13.962612,33.774119,MWI,3459739,158856,3618595,4.39,4325060,278663,4603723,6.05,5605321,557759,6163080,9.05,8346572,1090981,9437553,11.56,9714113,1662059,11376172,14.61,12809522,2357573,15167095,15.54,15509606,3112498,"18,622,104",16.71,10-50  million
Malaysia,Kuala Lumpur,3.139003,101.686855,MYS,5987479,2169627,8157106,26.6,7189615,3614363,10803978,33.45,7996841,5801284,13798125,42.04,9056319,8982002,18038321,49.79,8815864,14369744,23185608,61.98,8177303,19934986,28112289,70.91,7764706,23859558,"31,624,264",75.45,10-50  million
Maldives,MalÃ©,4.175496,73.509347,MDV,79844,10043,89887,11.17,102000,13768,115768,11.89,123144,35241,158385,22.25,165536,57679,223215,25.84,202701,77683,280384,27.71,231705,132806,364511,36.43,264503,171827,"436,330",39.38,"100,000 to 1 million"
Mali,Bamako,12.639232,-8.002889,MLI,4681248,582485,5263733,11.07,5096547,852498,5949045,14.33,5779587,1310539,7090126,18.48,6490937,1974251,8465188,23.32,7857692,3109998,10967690,28.36,9648205,5426880,15075085,36,10833708,7708272,"18,541,980",41.57,10-50  million
Malta,Valletta,35.898909,14.514553,MLT,32234,294316,326550,90.13,31176,271474,302650,89.7,32345,284300,316645,89.79,34068,320102,354170,90.38,29771,360316,390087,92.37,24572,389936,414508,94.07,25377,439915,"465,292",94.55,"100,000 to 1 million"
Marshall Islands,Majuro,7.116421,171.185774,MHL,9445,5217,14662,35.58,9485,10910,20395,53.49,12751,17825,30576,58.3,16529,30769,47298,65.05,16388,35771,52159,68.58,13857,38568,52425,73.57,12414,40713,"53,127",76.63,"Less than 100,000"
Mauritania,Nouakchott,18.07353,-15.958237,MRT,799126,59042,858168,6.88,981581,167327,1148908,14.56,1114191,419894,1534085,27.37,1231828,798312,2030140,39.32,1677337,1032022,2709359,38.09,1927929,1681614,3609543,46.59,2085266,2334918,"4,420,184",52.82,1-5 million
Mauritius,Port Louis,-20.166896,57.502332,MUS,427846,231505,659351,35.11,474487,351513,826000,42.56,556912,409127,966039,42.35,593973,464802,1058775,43.9,680434,506439,1186873,42.67,730796,519604,1250400,41.56,748132,516481,"1,264,613",40.84,1-5 million
Mexico,Mexico City,19.432608,-99.133208,MEX,18799605,19374507,38174112,50.75,21321317,30708544,52029861,59.02,23347563,46013308,69360871,66.34,24396134,60961740,85357874,71.42,25712699,76006974,101719673,74.72,26027207,91291734,117318941,77.82,26004442,103158834,"129,163,276",79.87,Over 50 million
Micronesia (country),Palikir,6.914712,158.161027,FSM,34600,9937,44537,22.31,46191,15240,61431,24.81,53669,19295,72964,26.44,71460,24871,96331,25.82,83442,23990,107432,22.33,80512,23104,103616,22.3,81683,23861,"105,544",22.61,"100,000 to 1 million"
Moldova,Chisinau,47.010453,28.86381,MDA,1948093,595907,2544000,23.42,2067850,976150,3044000,32.07,2024457,1371543,3396000,40.39,1967676,1728324,3696000,46.76,2016734,1622858,3639592,44.59,2043901,1518144,3562045,42.62,2039083,1510667,"3,549,750",42.56,1-5 million
Monaco,Monaco,43.737411,7.420816,MCO,0,22452,22452,100,0,23484,23484,100,0,26745,26745,100,0,29439,29439,100,0,32082,32082,100,0,37094,37094,100,0,38695,"38,695",100,"Less than 100,000"
Mongolia,Ulaanbaatar,47.886399,106.905744,MNG,614590,340915,955505,35.68,702689,576136,1278825,45.05,809616,880006,1689622,52.08,938462,1245683,2184145,57.03,1027709,1369727,2397436,57.13,879794,1832856,2712650,67.57,973042,2102605,"3,075,647",68.36,1-5 million
Montenegro,Podgorica,42.43042,19.259364,MNE,390288,90291,480579,18.79,374810,137597,512407,26.85,361814,210794,572608,36.81,315089,291283,606372,48.04,250788,354162,604950,58.54,222127,397301,619428,64.14,208671,413800,"622,471",66.48,"100,000 to 1 million"
Morocco,Rabat,33.97159,-6.849813,MAR,8709245,3619287,12328532,29.36,10483685,5516323,16000008,34.48,11769668,8250179,20019847,41.21,12839873,12039263,24879136,48.39,13462676,15386945,28849621,53.33,13606215,18803424,32409639,58.02,13613921,22125659,"35,739,580",61.91,10-50  million
Mozambique,Maputo,-25.891968,32.605135,MOZ,6881239,507456,7388695,6.87,8337912,823622,9161534,8.99,10289328,1559003,11848331,13.16,9935737,3311912,13247649,25,12810351,5257336,18067687,29.1,16511732,7709673,24221405,31.83,19149749,10519085,"29,668,834",35.45,10-50  million
Myanmar,Naypyidaw,19.763306,96.07851,MMR,16951331,4034792,20986123,19.23,20358550,6022881,26381431,22.83,25369991,7999721,33369712,23.97,30370966,10255284,40626250,25.24,33638163,12457299,46095462,27.03,35668365,14487531,50155896,28.89,37187573,16183036,"53,370,609",30.32,Over 50 million
Namibia,Windhoek,-22.560881,17.065755,NAM,494634,107910,602544,17.91,606421,173963,780384,22.29,758836,253836,1012672,25.07,1023445,391247,1414692,27.66,1284411,614846,1899257,32.37,1268784,904386,2173170,41.62,1292108,1241686,"2,533,794",49.01,1-5 million
Nauru,Yaren,-0.546686,166.921091,NRU,0,4433,4433,100,0,6496,6496,100,0,7488,7488,100,0,9155,9155,100,0,10037,10037,100,0,10025,10025,100,0,13649,"13,649",100,"Less than 100,000"
Nepal,Kathmandu,27.717245,85.323961,NPL,9712818,350193,10063011,3.48,11523291,474638,11997929,3.96,13994472,907691,14902163,6.09,17089334,1660072,18749406,8.85,20560341,3180570,23740911,13.4,22491897,4531240,27023137,16.77,23638584,5666414,"29,304,998",19.34,10-50  million
Netherlands,Amsterdam,52.370216,4.895168,NLD,4623139,6863492,11486631,59.75,4998580,8039946,13038526,61.66,4988512,9161288,14149800,64.74,4682215,10269295,14951510,68.68,3695515,12229998,15925513,76.8,2137737,14477657,16615394,87.13,1528765,15604089,"17,132,854",91.08,10-50  million
New Caledonia,NoumÃ©a,-22.255823,166.450524,NCL,49486,29514,79000,37.36,54620,57380,112000,51.23,59625,80425,140050,57.43,69083,101816,170899,59.58,81200,132030,213230,61.92,82163,167587,249750,67.1,83420,197040,"280,460",70.26,"100,000 to 1 million"
New Zealand,Wellington,-41.28646,174.776236,NZL,569279,1802521,2371800,76,531054,2279646,2810700,81.11,515870,2597030,3112900,83.43,508061,2821739,3329800,84.74,539268,3318432,3857700,86.02,602137,3748563,4350700,86.16,648806,4145094,"4,793,900",86.47,1-5 million
Nicaragua,Managua,12.114993,-86.236174,NIC,1072255,702444,1774699,39.58,1270271,1127825,2398096,47.03,1615465,1634445,3249910,50.29,1944837,2199728,4144565,53.08,2252759,2774037,5026796,55.18,2471983,3265740,5737723,56.92,2592793,3624788,"6,217,581",58.3,5-10 million
Niger,Niamey,13.511596,2.125385,NER,3192453,196311,3388764,5.79,4113827,396652,4510479,8.79,5183816,805088,5988904,13.44,6781445,1231416,8012861,15.37,9515381,1837592,11352973,16.19,13761185,2664393,16425578,16.22,17965802,3511546,"21,477,348",16.35,10-50  million
Nigeria,Abuja,9.076479,7.398574,NGA,38182075,6955737,45137812,15.41,46039103,9942297,55981400,17.76,57321403,16139321,73460724,21.97,66993856,28276132,95269988,29.68,79724569,42627440,122352009,34.84,89628433,68949828,158578261,43.48,96361319,94524992,"190,886,311",49.52,Over 50 million
North Korea,Pyongyang,39.039219,125.762524,PRK,6832228,4591948,11424176,40.2,6599963,7810437,14410400,54.2,7530492,9941648,17472140,56.9,8445157,11847897,20293054,58.38,9306453,13622622,22929075,59.41,9743929,14847670,24591599,60.38,9768648,15722317,"25,490,965",61.68,10-50  million
North Macedonia,Skopje,41.99646,21.43141,MKD,982222,506445,1488667,34.02,910665,810135,1720800,47.08,895348,1028849,1924197,53.47,842628,1153600,1996228,57.79,843473,1191346,2034819,58.55,888575,1182164,2070739,57.09,880177,1202983,"2,083,160",57.75,1-5 million
Northern Mariana Islands,Saipan,15.177801,145.750967,MNP,4895,5140,10035,51.22,3930,9197,13127,70.06,2236,14684,16920,86.78,4368,38170,42538,89.73,6804,62290,69094,90.15,4926,49498,54424,90.95,4671,50473,"55,144",91.53,"Less than 100,000"
Norway,Oslo,59.913869,10.752245,NOR,1793484,1787755,3581239,49.92,1341169,2534594,3875763,65.4,1203419,2882201,4085620,70.55,1189479,3051994,4241473,71.96,1076934,3414033,4490967,76.02,1021756,3867496,4889252,79.1,957614,4324609,"5,282,223",81.87,5-10 million
Oman,Muscat,23.58589,58.405923,OMN,461255,90485,551740,16.4,509121,214731,723852,29.67,605333,549046,1154379,47.56,614286,1197874,1812160,66.1,644813,1623178,2267991,71.57,755468,2285992,3041460,75.16,762201,3874061,"4,636,262",83.56,1-5 million
Pakistan,Islamabad,33.729388,73.093146,PAK,34981764,9926529,44908293,22.1,43674375,14416384,58090759,24.82,56157539,21910605,78068144,28.07,74754801,32923813,107678614,30.58,92835535,45687750,138523285,32.98,110869235,59690947,170560182,35,125219401,71796554,"197,015,955",36.44,Over 50 million
Palau,Ngerulmud,7.500384,134.624289,PLW,4163,5479,9642,56.82,4625,6855,11480,59.71,4568,7626,12194,62.54,4588,10500,15088,69.59,5688,13487,19175,70.34,5155,15315,20470,74.82,4484,17245,"21,729",79.36,"Less than 100,000"
Palestine,Ramallah,31.9073509,35.5354719,PSE,,,,,,,,,,,,,638796,1339452,1978248,67.71,819109,2103044,2922153,71.97,985208,2825894,3811102,74.15,1129312,3555465,"4,684,777",75.89,1-5 million
Panama,Panama City,9.101179,-79.402864,PAN,665602,467319,1132921,41.25,795505,723794,1519299,47.64,980445,998133,1978578,50.45,1139061,1331948,2471009,53.9,1145532,1884815,3030347,62.2,1270027,2373195,3643222,65.14,1337574,2761013,"4,098,587",67.36,1-5 million
Papua New Guinea,Port Moresby,-9.4438,147.180267,PNG,1935779,74898,2010677,3.73,2279984,247602,2527586,9.8,2873338,431135,3304473,13.05,3666359,646700,4313059,14.99,4836466,735756,5572222,13.2,6182817,925422,7108239,13.02,7170095,1081067,"8,251,162",13.1,5-10 million
Paraguay,Asuncion,-25.26374,-57.575926,PRY,1226041,676834,1902875,35.57,1557079,917027,2474106,37.06,1854689,1325941,3180630,41.69,2161902,2051840,4213742,48.69,2368663,2934037,5302700,55.33,2529842,3680035,6209877,59.26,2635972,4175325,"6,811,297",61.3,5-10 million
Peru,Lima,-12.046374,-77.042793,PER,5351619,4709896,10061515,46.81,5682495,7658574,13341069,57.41,6149642,11209478,17359120,64.57,6787872,15038786,21826658,68.9,6986133,18928746,25914879,73.04,6923368,22450278,29373646,76.43,7166470,24999015,"32,165,485",77.72,10-50  million
Philippines,Manila,14.599512,120.98422,PHL,18313087,7959938,26273025,30.3,23996687,11808042,35804729,32.98,29643960,17753008,47396968,37.46,32840767,29106581,61947348,46.99,42010159,35981410,77991569,46.13,51238471,42488153,93726624,45.33,55940227,48977863,"104,918,090",46.68,Over 50 million
Poland,Warsaw,52.229676,21.012229,POL,15443482,14193968,29637450,47.89,15638034,17026266,32664300,52.12,14910549,20663601,35574150,58.09,14760306,23350476,38110782,61.27,14646934,23611695,38258629,61.72,14877776,23165018,38042794,60.89,15150462,22825379,"37,975,841",60.1,10-50  million
Portugal,Lisbon,38.722252,-9.139337,PRT,5761501,3096215,8857716,34.96,5312077,3368354,8680431,38.8,5587795,4178517,9766312,42.79,5199759,4783459,9983218,47.92,4692296,5597602,10289898,54.4,4169291,6403809,10573100,60.57,3638623,6655095,"10,293,718",64.65,10-50  million
Puerto Rico,San Juan,18.466334,-66.105722,PRI,1307582,1050418,2358000,44.55,1132645,1585355,2718000,58.33,1031210,2174790,3206000,67.83,249641,3287359,3537000,92.94,213889,3596716,3810605,94.39,229804,3491721,3721525,93.83,214013,3123164,"3,337,177",93.59,1-5 million
Qatar,Doha,25.285447,51.53104,QAT,6977,40407,47384,85.28,12754,96760,109514,88.35,23803,199972,223775,89.36,34371,442074,476445,92.79,21849,570418,592267,96.31,26677,1752999,1779676,98.5,24334,2614877,"2,639,211",99.08,1-5 million
Romania,Bucharest,44.426767,26.102538,ROU,12110087,6296818,18406905,34.21,12085640,8164758,20250398,40.32,11995463,10247190,22242653,46.07,10854514,12347321,23201835,53.22,10547299,11895672,22442971,53,9348183,10898688,20246871,53.83,9022343,10564196,"19,586,539",53.94,10-50  million
Russia,Moscow,55.755826,37.6173,RUS,55475143,64421857,119897000,53.73,48939317,81464683,130404000,62.47,42049135,96960865,139010000,69.75,39454570,108837430,148292000,73.39,39067982,107528575,146596557,73.35,37587976,105261473,142849449,73.69,37146786,107348258,"144,495,044",74.29,Over 50 million
Rwanda,Kigali,-1.957875,30.112735,RWA,2857159,76269,2933428,2.6,3634621,119920,3754541,3.19,4898023,242693,5140716,4.72,6843907,391891,7235798,5.42,6827787,1197916,8025703,14.93,8511642,1735200,10246842,16.93,10117717,2090690,"12,208,407",17.13,10-50  million
Saint Kitts and Nevis,Basseterre,17.302606,-62.717692,KNA,37043,14152,51195,27.64,29561,15324,44885,34.14,27705,15505,43210,35.88,26702,14132,40834,34.61,30501,14873,45374,32.78,35331,16114,51445,31.32,38314,17031,"55,345",30.77,"Less than 100,000"
Saint Lucia,Castries,14.010109,-60.987469,LCA,70605,19292,89897,21.46,79258,24902,104160,23.91,86673,31314,117987,26.54,97629,40556,138185,29.35,113358,43591,156949,27.77,140739,31841,172580,18.45,145558,33286,"178,844",18.61,"100,000 to 1 million"
Saint Vincent and the Grenadines,Kingstown,13.160025,-61.224816,VCT,59948,21001,80949,25.94,62699,27753,90452,30.68,64454,36051,100505,35.87,62988,44517,107505,41.41,59143,48755,107898,45.19,55793,53522,109315,48.96,52988,56909,"109,897",51.78,"100,000 to 1 million"
Samoa,Apia,-13.850696,-171.751355,WSM,88084,20562,108646,18.93,114035,29141,143176,20.35,122621,32936,155557,21.17,128338,34528,162866,21.2,136236,38374,174610,21.98,148819,37386,186205,20.08,160193,36247,"196,440",18.45,"100,000 to 1 million"
San Marino,San Marino,43.935591,12.447281,SMR,7868,7529,15397,48.9,7693,11445,19138,59.8,4009,17352,21361,81.23,2308,21735,24043,90.4,1799,25619,27418,93.44,1325,29785,31110,95.74,978,32422,"33,400",97.07,"Less than 100,000"
Sao Tome and Principe,Sao Tome,0.330192,6.733343,STP,53926,10327,64253,16.07,52335,21918,74253,29.52,63158,31791,94949,33.48,64181,49712,113893,43.65,64557,74049,138606,53.42,61255,113521,174776,64.95,57277,147050,"204,327",71.97,"100,000 to 1 million"
Saudi Arabia,Riyadh,24.749403,46.902838,SAU,2809496,1277043,4086539,31.25,2995877,2840512,5836389,48.67,3325440,6415159,9740599,65.86,3823250,12503565,16326815,76.58,4184424,16579888,20764312,79.85,4913584,22512092,27425676,82.08,5394621,27543592,"32,938,213",83.62,10-50  million
Senegal,Dakar,14.764504,-17.366029,SEN,2469197,737552,3206749,23,2980253,1277252,4257505,30,3592212,2000434,5592646,35.77,4616784,2938833,7555617,38.9,5898802,3985250,9884052,40.32,7262408,5653821,12916229,43.77,8442012,7408555,"15,850,567",46.74,10-50  million
Serbia,Belgrade,44.786568,20.448922,SRB,,,,,,,,,,,,,3763187,3822813,7586000,50.39,3550045,3966301,7516346,52.77,3281657,4009779,7291436,54.99,3093871,3928397,"7,022,268",55.94,5-10 million
Seychelles,Victoria,-4.619143,55.451315,SYC,30160,11540,41700,27.67,32660,20940,53600,39.07,32032,31229,63261,49.37,35261,34246,69507,49.27,40214,40917,81131,50.43,41890,47880,89770,53.34,41921,53922,"95,843",56.26,"Less than 100,000"
Sierra Leone,Freetown,8.465677,-13.231722,SLE,1898515,398595,2297110,17.35,2046951,645308,2692259,23.97,2361900,1003541,3365441,29.82,2878338,1433908,4312246,33.25,2938221,1626076,4564297,35.63,3949120,2509600,6458720,38.86,4410691,3146521,"7,557,212",41.64,5-10 million
Singapore,Singapore,1.280095,103.850949,SGP,0,1646400,1646400,100,0,2074500,2074500,100,0,2413945,2413945,100,0,3047132,3047132,100,0,4027887,4027887,100,0,5076732,5076732,100,0,5612253,"5,612,253",100,5-10 million
Sint Maarten (Dutch part),Philipsburg,18.0237,-63.0458,SXM,,,,,,,,,,,,,,,,,0,30519,30519,100,0,34056,34056,100,0,41109,"41,109",100,"Less than 100,000"
Slovakia,Bratislava,48.145892,17.107137,SVK,2706748,1361347,4068095,33.46,2674965,1863258,4538223,41.06,2408338,2571477,4979815,51.64,2305623,2993564,5299187,56.49,2358481,3030239,5388720,56.23,2443126,2948302,5391428,54.68,2515896,2923996,"5,439,892",53.75,5-10 million
Slovenia,Ljubljana,46.056947,14.505751,SVN,1137766,446954,1584720,28.2,1086612,638279,1724891,37,987828,913487,1901315,48.05,991288,1006873,1998161,50.39,979466,1009459,1988925,50.75,969840,1078743,2048583,52.66,945062,1121686,"2,066,748",54.27,1-5 million
Solomon Islands,Honiara,-9.445638,159.9729,SLB,111067,6799,117866,5.77,145997,14293,160290,8.92,206218,24389,230607,10.58,269190,42650,311840,13.68,347363,65246,412609,15.81,421979,105811,527790,20.05,468986,142357,"611,343",23.29,"100,000 to 1 million"
Somalia,Mogadishu,2.046934,45.318162,SOM,2278837,477110,2755947,17.31,2663397,781156,3444553,22.68,4657233,1701893,6359126,26.76,5203442,2193905,7397347,29.66,6015433,2996046,9011479,33.25,7315101,4738122,12053223,39.31,8198170,6544353,"14,742,523",44.39,10-50  million
South Africa,Pretoria,-25.747868,28.229271,ZAF,9318644,8138211,17456855,46.62,11920138,10919313,22839451,47.81,15348963,14411508,29760471,48.42,18015155,19545370,37560525,52.04,19713019,26015296,45728315,56.89,19489717,32094946,51584663,62.22,19368909,37348247,"56,717,156",65.85,Over 50 million
South Korea,Seoul,37.566535,126.977969,KOR,18081445,6930929,25012374,27.71,19117521,13123306,32240827,40.7,16499970,21623805,38123775,56.72,11212890,31656393,42869283,73.84,9579783,37428328,47008111,79.62,8951455,40602657,49554112,81.94,9519703,41946498,"51,466,201",81.5,Over 50 million
South Sudan,Juba,4.859363,31.57125,SSD,2696635,258517,2955152,8.75,3332802,314907,3647709,8.63,4304386,400838,4705224,8.52,5002657,765824,5768481,13.28,5594780,1105876,6700656,16.5,8269192,1798000,10067192,17.86,10142816,2432898,"12,575,714",19.35,10-50  million
Spain,Madrid,40.416775,-3.70379,ESP,13227520,17227480,30455000,56.57,11484091,22330440,33814531,66.04,10201721,27289444,37491165,72.79,9580406,29286916,38867322,75.35,9630000,30937864,40567864,76.26,10041047,36535850,46576897,78.44,9277148,37294880,"46,572,028",80.08,10-50  million
Sri Lanka,Sri Jayawardenepura Kotte,6.89407,79.902478,LKA,8252005,1622476,9874481,16.43,10288513,2197243,12485756,17.6,12238134,2797722,15035856,18.61,14117651,3212062,17329713,18.53,15329818,3452120,18781938,18.38,16517001,3681352,20198353,18.23,17501735,3942265,"21,444,000",18.38,10-50  million
Sudan,Khartoum,15.500654,32.559899,SDN,6733760,810731,7544491,10.75,8582855,1698845,10281700,16.52,11611922,2895546,14507468,19.96,14383365,5764225,20147590,28.61,18395474,8855061,27250535,32.49,23007992,11377971,34385963,33.09,26602024,13931306,"40,533,330",34.37,10-50  million
Suriname,Paramaribo,5.852036,-55.203828,SUR,152928,137038,289966,47.26,200680,170593,371273,45.95,127117,235660,362777,64.96,139738,267734,407472,65.71,158515,313875,472390,66.44,177065,349038,526103,66.34,191326,372076,"563,402",66.04,"100,000 to 1 million"
Swaziland,Mbabane,-26.31667,31.13333,SWZ,335511,13663,349174,3.91,402471,43258,445729,9.71,503948,99424,603372,16.48,687358,174015,861373,20.2,820663,240805,1061468,22.69,932444,270399,1202843,22.48,1044240,323014,"1,367,254",23.63,1-5 million
Sweden,Stockholm,59.329323,18.068581,SWE,2059029,5425627,7484656,72.49,1525398,6517403,8042801,81.03,1405560,6904971,8310531,83.09,1446443,7112392,8558835,83.1,1417231,7454878,8872109,84.03,1401467,7976659,9378126,85.06,1294108,8773636,"10,067,744",87.15,10-50  million
Switzerland,Bern,46.947974,7.447447,CHE,1549119,3778708,5327827,70.92,1616732,4564145,6180877,73.84,1612903,4706505,6319408,74.48,1751004,4964515,6715519,73.93,1912232,5272018,7184250,73.38,2065228,5759681,7824909,73.61,2221398,6244619,"8,466,017",73.76,5-10 million
Syria,Damascus,33.513807,36.276528,,2890139,1683373,4573512,36.81,3597899,2752642,6350541,43.35,4759388,4171386,8930774,46.71,6356135,6090036,12446171,48.93,7885905,8524943,16410848,51.95,9332362,11686472,21018834,55.6,8495489,9774379,"18,269,868",53.5,10-50  million
Tajikistan,Dushanbe,38.559772,68.787038,TJK,1394809,692229,2087038,33.17,1849583,1080496,2930079,36.88,2566286,1339127,3905413,34.29,3611005,1672723,5283728,31.66,4568849,1647356,6216205,26.5,5615070,2026560,7641630,26.52,6514186,2407157,"8,921,343",26.98,5-10 million
Tanzania,Dodoma,-6.162959,35.751607,TZA,9545998,528509,10074507,5.25,12537223,1068306,13605529,7.85,15963823,2719334,18683157,14.56,20651812,4807792,25459604,18.88,26553263,7624779,34178042,22.31,33138433,12960158,46098591,28.11,38367338,18942681,"57,310,019",33.05,Over 50 million
Thailand,Bangkok,13.756331,100.501765,THA,22007603,5389572,27397175,19.67,29180024,7704889,36884913,20.89,34690321,12695002,47385323,26.79,39933892,16648929,56582821,29.42,43198017,19760004,62958021,31.39,37733713,29475095,67208808,43.86,35071057,33966456,"69,037,513",49.2,Over 50 million
Timor,Dili,-8.556856,125.560314,TLS,449500,50450,499950,10.09,527149,77976,605125,12.89,490715,96848,587563,16.48,595215,156718,751933,20.84,660129,211478,871607,24.26,801879,307712,1109591,27.73,904670,391641,"1,296,311",30.21,1-5 million
Togo,LomÃ©,6.172497,1.231362,TGO,1420913,159600,1580513,10.1,1665339,450183,2115522,21.28,2049798,671041,2720839,24.66,2704292,1082648,3786940,28.59,3334768,1635599,4970367,32.91,4062199,2440753,6502952,37.53,4588007,3209687,"7,797,694",41.16,5-10 million
Tonga,NukuÊ»alofa,-21.139342,-175.204947,TON,50789,10812,61601,17.55,67337,17032,84369,20.19,73332,19675,93007,21.15,73549,21604,95153,22.7,75511,22571,98082,23.01,79780,24357,104137,23.39,82993,25027,"108,020",23.17,"100,000 to 1 million"
Trinidad and Tobago,Port of Spain,10.654901,-61.501926,TTO,558681,289798,848479,34.15,538885,407108,945993,43.03,517866,567442,1085308,52.28,560559,661341,1221900,54.12,559118,708866,1267984,55.9,610594,717506,1328100,54.02,640682,728443,"1,369,125",53.21,1-5 million
Tunisia,Tunis,36.806495,10.181532,TUN,2609707,1566559,4176266,37.51,2860035,2200362,5060397,43.48,3147849,3220318,6368167,50.57,3462220,4770577,8232797,57.95,3546802,6152395,9699197,63.43,3547672,7092259,10639931,66.66,3616244,7915883,"11,532,127",68.64,10-50  million
Turkey,Ankara,39.933364,32.859742,TUR,18814426,8657905,27472331,31.51,21541675,13334592,34876267,38.23,24723263,19252658,43975921,43.78,21998436,31923263,53921699,59.2,22297834,40942287,63240121,64.74,21101377,51225537,72326914,70.83,20473707,60271313,"80,745,020",74.64,Over 50 million
Turkmenistan,Ashgabat,37.960077,58.326063,TKM,859154,744104,1603258,46.41,1146319,1048854,2195173,47.78,1522464,1354344,2876808,47.08,2023418,1660548,3683966,45.08,2442640,2073491,4516131,45.91,2620371,2466839,5087210,48.49,2812647,2945428,"5,758,075",51.15,5-10 million
Turks and Caicos Islands,Cockburn Town,21.467458,-71.13891,TCA,2996,2730,5726,47.68,2754,2879,5633,51.11,3364,4155,7519,55.26,2964,8588,11552,74.34,2916,15957,18873,84.55,3029,27965,30994,90.23,2546,32900,"35,446",92.82,"Less than 100,000"
Tuvalu,Funafuti,-8.520066,179.198128,TUV,5134,970,6104,15.89,5690,1613,7303,22.09,5651,2401,8052,29.82,5342,3661,9003,40.66,5085,4335,9420,46.02,4760,5771,10531,54.8,4306,6886,"11,192",61.53,"Less than 100,000"
Uganda,Kampala,0.347596,32.58252,UGA,6488379,299835,6788214,4.42,8816578,629486,9446064,6.66,11604058,945482,12549540,7.53,15507374,1931533,17438907,11.08,20484827,3554447,24039274,14.79,27341363,6573770,33915133,19.38,32920466,9942492,"42,862,958",23.2,10-50  million
Ukraine,Kiev,50.4501,30.5234,UKR,22699676,19962473,42662149,46.79,21268619,25818142,47086761,54.83,19141553,30827259,49968812,61.69,17250458,34641542,51892000,66.76,16156725,33019123,49175848,67.14,14405235,31465465,45870700,68.6,13787375,31043784,"44,831,159",69.25,10-50  million
United Arab Emirates,Abu Dhabi,24.299174,54.697277,ARE,24548,68086,92634,73.5,47571,187928,235499,79.8,201076,841308,1042384,80.71,389688,1470486,1860174,79.05,623539,2531386,3154925,80.24,1316114,6954570,8270684,84.09,1292708,8107437,"9,400,145",86.25,5-10 million
United Kingdom,London,51.507351,-0.127758,GBR,11295344,41104656,52400000,78.44,12737421,42925829,55663250,77.12,12118256,44195960,56314216,78.48,12514322,44733264,57247586,78.14,12572963,46319551,58892514,78.65,11736055,51030310,62766365,81.3,11129375,54892898,"66,022,273",83.14,Over 50 million
United States,Washington,38.907192,-77.036871,USA,54208527,126462473,180671000,70,54129627,150922373,205052000,73.6,59673829,167551171,227225000,73.74,61656881,187966119,249623000,75.3,59093274,223069137,282162411,79.06,59479592,249858829,309338421,80.77,58440535,267278643,"325,719,178",82.06,Over 50 million
United States Virgin Islands,Charlotte Amalie,18.3419,-64.930701,VIR,14145,18355,32500,56.48,19302,44174,63476,69.59,19781,79855,99636,80.15,12803,91160,103963,87.69,8055,100587,108642,92.59,5858,102500,108358,94.59,4717,102551,"107,268",95.6,"100,000 to 1 million"
Uruguay,Montevideo,-34.901113,-56.164531,URY,501612,2037039,2538651,80.24,495424,2314379,2809803,82.37,425879,2489899,2915778,85.39,342938,2767051,3109989,88.97,264770,3056475,3321245,92.03,188495,3185920,3374415,94.41,164541,3292209,"3,456,750",95.24,1-5 million
Uzbekistan,Tashkent,41.299496,69.240073,UZB,5644546,2904947,8549493,33.98,7663952,4446076,12110028,36.71,9439198,6500546,15939744,40.78,12026038,8483962,20510000,41.37,13280156,11370244,24650400,46.13,14008143,14554257,28562400,50.96,16015470,16371730,"32,387,200",50.55,10-50  million
Vanuatu,Port Vila,-17.733251,168.327325,VUT,57072,6627,63699,10.4,74865,10524,85389,12.32,98588,17044,115632,14.74,119191,27443,146634,18.72,144954,40109,185063,21.67,178493,57802,236295,24.46,206733,69511,"276,244",25.16,"100,000 to 1 million"
Venezuela,Caracas,10.480594,-66.903606,VEN,3127330,5019517,8146847,61.61,3261723,8326038,11587761,71.85,3193836,12150080,15343916,79.19,3121505,16740451,19861956,84.28,3046594,21441746,24488340,87.56,3459271,25568762,29028033,88.08,3778730,28198335,"31,977,065",88.18,10-50  million
Vietnam,Hanoi,21.027764,105.83416,VNM,27868047,4802582,32670629,14.7,35463753,7943534,43407287,18.3,43907436,10465078,54372514,19.25,54392385,13817220,68209605,20.26,60716759,19568803,80285562,24.37,61561828,26910684,88472512,30.42,61898018,33642782,"95,540,800",35.21,Over 50 million
Yemen,Sana'a,15.369445,44.191007,YEM,4701471,470664,5172135,9.1,5370033,823777,6193810,13.3,6777854,1342643,8120497,16.53,9533380,2523659,12057039,20.93,13179571,4695154,17874725,26.27,16105489,7501290,23606779,31.78,18075749,10174671,"28,250,420",36.02,10-50  million
Zambia,Lusaka,-15.387526,28.322817,ZMB,2492359,552487,3044846,18.14,2907099,1266829,4173928,30.35,3544433,2344797,5889230,39.82,4863953,3163300,8027253,39.41,6866145,3665076,10531221,34.8,8399353,5450680,13850033,39.35,9747757,7346373,"17,094,130",42.98,10-50  million
Zimbabwe,Harare,-17.825166,31.03351,ZWE,3274901,472468,3747369,12.61,4277027,898591,5175618,17.36,5561475,1602697,7164172,22.37,7231232,2951881,10183113,28.99,8096264,4125987,12222251,33.76,9410223,4676094,14086317,33.2,11201159,5328745,"16,529,904",32.24,10-50  million
